Irish_B	blath	bˠl̪ˠaː
Old_Irish	blath	bla:θ
Norwegian	blomst	blɔmst
Swedish	blomster	ˈblɔmstər
Stavangersk	blamster	ˈblɔmstəʁ
Faroese	bloma	ˈb̥lɔuːma
Ovdalian	bljamme	bljɔ̀mːɛ
Old_Norse	blom	bloːm
Old_Swedish2	bloma	ˈbloːma
Cornish	bleujen	'blœʤɛn
Frisian	blom	blom
Danish_Fjolde	blom	blom
Old_Swedish	blomster	ˈblomster
Icelandic_St	blom	b̥louːm
Gutnish_Lau	blauma	ˈbloumo
German	blume	'blu:mə
Dutch_List	bloem	blum
Swedish	blomma	ˈblʊ̀mːa
Danish	blomst	b̥lʌmˀsd̥ʰ
Italian	fiore	'fjore
English	flower	flaʊə
Catalan	flor	flɔ
Latin	flos	floːs
French	fleur	flœʀ
Portuguese_St	flor	floɾ
Spanish	flor	floɾ
Brazilian	flor	flox
Rumanian_List	floare	ˈflware
