Irish_A	AIG
Irish_B	AG
Vlach	A
Italian	A
Italian	AD
Ladin	A
Ladin	AD
Ladin	ADA
Provencal	A
French	A
Walloon	A
French_Creole_C	A
French_Creole_D	A
French_Creole_D	A
Sardinian_N	A
Sardinian_L	A
Sardinian_C	A
Spanish	A
Brazilian	A
Swedish_Up	AT
Faroese	A
English	AT
Lithuanian_O	ANT
Baluchi	A
