Welsh_N	ASGWRN
Welsh_C	ASGWRN
Breton_List	ASKOURN
Breton_SE	ASKORN
Breton_ST	ASKORN
Romanian_List	OS
Vlach	OS
Italian	OSSO
Ladin	OSS
Provencal	OS
Provencal	OUSSAIO
French	OS
Walloon	OHE
French_Creole_C	ZO
French_Creole_D	ZOS
Sardinian_N	OSSU
Sardinian_L	OSSU
Sardinian_C	OSSU
Spanish	HUESO
Portuguese_ST	OSSO
Brazilian	OSSO
Catalan	OS
Greek_K	OSTOUN
Armenian_Mod	OSKOR
Armenian_List	VOSGOR
Ossetic	YSTAEG
Persian_List	OSTOKHAN
Tadzik	USTUXON
Wakhi	YUSC
Wakhi	USTUXON
ALbanian_C	AST
