Lithuanian_O	DIENA
Lithuanian_ST	DIENA
Latvian	DIENA
Slovenian	DAN
Lusatian_L	ZEN
Lusatian_U	DZEN
Czech	DEN
Slovak	DEN
Czech_E	DENY
Ukrainian	DEN*
Byelorussian	DZEN*
Polish	DZIEN
Russian	DEN
Macedonian	DEN
Bulgarian	DEN
Serbocroatian	DAN
Kashmiri	DEN
Panjabi_ST	DIN
Hindi	DIN
Bengali	DIN
Nepali_List	DIN
