Welsh_N	CI
Welsh_C	CI
Breton_List	KI
Breton_SE	KI
Breton_ST	KI
Romanian_List	CIINE
Vlach	KYNE
Italian	CANE
Ladin	CHAUN
Provencal	CHIN
Provencal	CAN
French	CHIEN
Walloon	TCHIN
French_Creole_C	SIE
French_Creole_D	SYE
Sardinian_N	KANE
Sardinian_L	CANE
Sardinian_C	KANI
Portuguese_ST	CAO
Brazilian	CAO
Catalan	CA
Greek_K	KUON
Albanian_T	GEN
Albanian_Top	KEN
Albanian_G	KJENI
Albanian_K	KEN
ALbanian_C	KEN
