Irish_A	ATHAIR
Irish_B	ATHAIR
Italian	PADRE
Provencal	PAIRE
Provencal	PAI
French	PERE
Walloon	PERE
Spanish	PADRE
Portuguese_ST	PAI
Brazilian	PAI
Catalan	PARE
German_ST	VATER
Penn_Dutch	FOTTER
Dutch_List	VADER
Afrikaans	VADER
Flemish	VADER
Frisian	FAER
Swedish_Up	FAR
Swedish_Up	FADER
Swedish_VL	FAR
Swedish_List	FADER
Danish	FADER
Riksmal	FAR
Icelandic_ST	FAOIR
Faroese	FADIR
English	FATHER
Greek_ML	PATERAS
Greek_MD	PATERAS
Greek_Mod	PATERAS
Greek_D	PATERAS
Greek_K	PATER
Ossetic	FYD
Persian_List	PEDAR
Tadzik	PADAR
