Slovenian	PERU
Lusatian_L	PERO
Lusatian_U	PJERO
Czech	PERO
Slovak	PERO
Czech_E	PERO
Ukrainian	PERO
Byelorussian	PERA
Polish	PIORO
Russian	PERO
Macedonian	PERO
Macedonian	PERJE
Macedonian	PERJA
Bulgarian	PERO
Serbocroatian	PERO
Lahnda	PER
Hindi	PER
Persian_List	PAR
Tadzik	PAR
Baluchi	PHAR
Wakhi	PUR
