Lithuanian_O	UGNIS
Lithuanian_ST	UGNIS
Latvian	UGUNS
Slovenian	OGEN
Lusatian_L	HOGEN
Lusatian_U	WOHEN
Czech	OHEN
Slovak	OHEN
Czech_E	OHENY
Ukrainian	VOGON*
Byelorussian	VAGON*
Polish	OGIEN
Russian	OGON
Macedonian	OGAN
Macedonian	OGNI
Bulgarian	OGEN
Marathi	AG
Gujarati	AG
Panjabi_ST	EGG
Hindi	AG
Bengali	AGUN
Nepali_List	AGO
Khaskura	AGO
