Lithuanian_ST	MIGLA
Latvian	MIGLA
Slovenian	MEGLA
Lusatian_L	MLA
Lusatian_U	MHLA
Czech	MLHA
Slovak	HMLA
Czech_E	MHLA
Byelorussian	IMHLA
Polish	MGLA
Macedonian	MAGLA
Bulgarian	MEGLA
Serbocroatian	MAGLA
Greek_MD	OMICHLE
Greek_D	OMICHLE
Greek_K	OMICHLE
Armenian_List	MEK
Ossetic	MIG*
Ossetic	C*AEXMIG*
Afghan	MIH
Persian_List	MEH
