Welsh_N	FFRWYTH
Welsh_C	FFRWYTH
Breton_List	FROUEZ
Breton_SE	FREH
Breton_ST	FROUEZH
Romanian_List	FRUCT
Italian	FRUTTO
Ladin	FRUT
Provencal	FRU
Provencal	FRUCHO
French	FRUIT
Walloon	FRUT
Walloon	FRUT*
French_Creole_C	FWITAZ
French_Creole_D	FWI
Sardinian_N	FRUTTORA
Sardinian_L	FRUTTU
Sardinian_C	FRUTTA
Spanish	FRUTO
Portuguese_ST	FRUCTO
Brazilian	FRUTA
Catalan	FRUYT
German_ST	FRUCHT
Dutch_List	VRUCHT
Afrikaans	VRUG
Flemish	VRUCHT
Frisian	FRUCHT
Swedish_Up	FRUKT
Swedish_VL	FRUKT
Swedish_List	FRUKT
Danish	FRUGT
English	FRUIT
Greek_ML	FROUTO
Greek_MD	FROUTO
Greek_Mod	FRUTO
Greek_D	FROUTO
Albanian_Top	FRUTA
Albanian_K	FRUTO
