Welsh_N	GWYRDD
Welsh_C	GWYRDD
Breton_List	GWER
Breton_SE	GUERH
Breton_ST	GWER
Romanian_List	VERDE
Vlach	VEARDE
Italian	VERDE
Ladin	VERD
Ladin	VIERD
Provencal	VERT
Provencal	ERDO
French	VERT
Walloon	VERT
French_Creole_C	VE
French_Creole_D	VE
Sardinian_N	VIRDE
Sardinian_L	BIRDE
Sardinian_C	BIRDI
Spanish	VERDE
Portuguese_ST	VERDE
Brazilian	VERDE
Catalan	VERT
ALbanian_C	VIRDHI
