Welsh_N	GWALLT
Welsh_C	GWALLT
Romani	BALA
Kashmiri	WAL
Gujarati	WAL
Panjabi_ST	VAL
Lahnda	WAL
Hindi	BAL
Nepali_List	BAL
Slovenian	LASJE
Lusatian_L	LOS
Lusatian_U	WLOS
Czech	VLASY
Slovak	VLAS
Czech_E	VLASI
Ukrainian	VOLOSSJA
Ukrainian	VOLOS
Byelorussian	VOLAS
Polish	WLOSY
Russian	VOLOSY
Greek_K	LASIOS
Albanian_K	LES
Albanian_Top	LES
Albanian_T	LESHRA
