Swedish_VL	JA
Romanian_List	EU
Vlach	EO
Italian	IO
Ladin	EAU
Provencal	IEU
French	JE
Spanish	YO
Portuguese_ST	EU
Brazilian	EU
Catalan	JO
Sardinian_N	JEO
Lusatian_L	JA
Lusatian_U	JA
Czech	JA
Slovak	JA
Czech_E	YA
Ukrainian	JA
Byelorussian	JA
Polish	JA
Russian	JA
Serbocroatian	JA
