Welsh_N	I
English	I
German_ST	ICH
Penn_Dutch	ICH
Dutch_List	IK
Afrikaans	EK
Afrikaans	EKKE
Flemish	IK
Frisian	IK
Frisian	IKKE
Sardinian_L	EGO
Swedish_Up	JAG
Swedish_VL	JAG
Swedish_VL	JAG
Swedish_List	JAG
Danish	JEG
Riksmal	JEG
Icelandic_ST	EG
Faroese	EG
Greek_ML	EGO
Greek_MD	EGO
Greek_Mod	EGHO
Greek_D	EGO
Greek_K	EGO
