Irish_A	LOCH
Irish_B	LOCH
Breton_List	LOUC*H
Breton_List	LOC*H
Romanian_List	LAC
Italian	LAGO
Ladin	LEJ
Ladin	LEIH
Provencal	LAU
French	LAC
Walloon	LAC
Sardinian_N	LAGU
Sardinian_L	LAGU
Sardinian_C	LAGU
Spanish	LAGO
Portuguese_ST	LAGO
Brazilian	LAGO
Catalan	LLACH
Penn_Dutch	LOCH
English	LAKE
Armenian_Mod	LIC
Armenian_List	LICH
Albanian_T	LIGEN
ALbanian_C	LAGHU
