Romanian_List	LUNG
Vlach	LUNGU
Italian	LUNGO
Ladin	LUNGIA
Provencal	LONG
Provencal	LONGO
French	LONG
Walloon	LONG
Walloon	LONGUE
French_Creole_C	LON
French_Creole_D	LON
Sardinian_N	LONGU
Sardinian_L	LONGU
Sardinian_C	LONGU
Portuguese_ST	LONGO
German_ST	LANG
Penn_Dutch	LUNG
Dutch_List	LANG
Afrikaans	LANG
Flemish	LANG
Frisian	LANG
Swedish_Up	LANG
Swedish_VL	LONG
Swedish_List	LANG
Danish	LANG
Riksmal	LANG
Icelandic_ST	LANGR
Faroese	LANGUR
English	LONG
Sranan	LANGA
Romani	LUNGO
