Dutch_List	ZOUT
Afrikaans	SOUT
Flemish	ZOUT
Sranan	ZOUTOE
Welsh_N	HALEN
Welsh_C	HALEN
Breton_List	HOLEN
Breton_List	C*HOALEN
Breton_SE	HOLEN
Breton_ST	HOLEN
Greek_ML	HALATI
Greek_MD	HALATI
Greek_Mod	ALATI
Greek_D	HALATI
Greek_K	HALAS
Irish_A	SALANN
Irish_B	SALANN
Italian	SALE
Ladin	SAL
Provencal	SAU
French	SEL
Walloon	SE
French_Creole_C	SEL
French_Creole_D	SEL
Sardinian_N	SALE
Sardinian_L	SALE
Sardinian_C	SALI
Spanish	SAL
Portuguese_ST	SAL
Brazilian	SAL
Catalan	SAL
German_ST	SALZ
Penn_Dutch	SOLSZ
Frisian	SALT
Swedish_Up	SALT
Swedish_VL	SALT
Swedish_List	SALT
Danish	SALT
Riksmal	SALT
Icelandic_ST	SALT
Faroese	SALT
English	SALT
Latvian	SALS
Slovenian	SOV
Lusatian_L	SOL
Lusatian_U	SOL
Czech	SUL
Slovak	SOL
Czech_E	SUL
Ukrainian	SIL*
Byelorussian	SOL*
Polish	SOL
Russian	SOL
Macedonian	SOL
Bulgarian	SOL
Serbocroatian	SOL
