German_ST	GLATT
Penn_Dutch	GLOT
Dutch_List	GELIJK
Dutch_List	GLAD
Afrikaans	GLAD
Flemish	GLAD
Frisian	GLAD
Swedish_List	GLATT
Danish	GLAT
Riksmal	GLATT
Sranan	GLATI
Latvian	GLUDS
Slovenian	GLADKO
Lusatian_L	GLADKI
Lusatian_U	HLADKI
Czech	HLADKY
Slovak	HLADKY
Czech_E	HLADKE
Ukrainian	HLADKYJ
Byelorussian	HLADKI
Polish	GLADKI
Russian	GLADKIJ
Bulgarian	GLADKO
Serbocroatian	GLADAK
