Irish_A	TRI
Irish_B	TRI
Welsh_N	TRI
Welsh_C	TRI
Breton_List	TRI
Breton_SE	TRI
Breton_ST	TRI
Romanian_List	TREI
Vlach	TRE
Italian	TRE
Ladin	TRAIS
Provencal	TRES
French	TROIS
Walloon	TREUS
Sardinian_N	TRES
Sardinian_L	TRES
Sardinian_C	TRESI
Spanish	TRES
Portuguese_ST	TRES
Brazilian	TRES
Catalan	TRES
German_ST	DREI
Penn_Dutch	DREI
Dutch_List	DRIE
Afrikaans	DRIE
Flemish	DRIE
Frisian	TRIJE
Swedish_Up	TRE
Swedish_VL	TRI
Swedish_List	TRE
Danish	TRE
Riksmal	TRE
Icelandic_ST	THRIR
Faroese	TRIGGIR
English	THREE
Sranan	DRI
Lithuanian_O	TRYS
Lithuanian_ST	TRYS
Latvian	TRIS
Slovenian	TRI
Lusatian_L	TSI
Lusatian_U	TRI
Czech	TRI
Slovak	TRI
Czech_E	TRI
Ukrainian	TRY
Byelorussian	TRY
Polish	TRZY
Russian	TRI
Macedonian	TRI
Bulgarian	TRI
Serbocroatian	TRI
Romani	TRIN
Kashmiri	TREH
Gujarati	TRAN
Lahnda	TRAE
Greek_ML	TRIA
Greek_MD	TRIA
Greek_Mod	TRIA
Greek_D	TREIS
Greek_D	TRIA
Greek_K	TREIS
Greek_K	TRIA
Afghan	DRE
Waziri	DRE
Wakhi	TROI
Albanian_T	TRE
Albanian_T	TRI
Albanian_Top	TRI
Albanian_G	TRE
Albanian_K	TRE
ALbanian_C	TRI
