Slovenian	PIT
Lusatian_L	PIS
Lusatian_U	PIC
Czech	PITI
Slovak	PIT
Czech_E	PIT
Ukrainian	PYTY
Byelorussian	PIC*
Polish	PIC
Russian	PIT
Macedonian	PIE
Bulgarian	DA-PIE
Serbocroatian	PITI
Romani	PEAV
Marathi	PINE.
Gujarati	PIWU
Panjabi_ST	PINA
Lahnda	PIWEN
Hindi	PINA
Nepali_List	PANI-KHANU
Nepali_List	PIUNU
Greek_ML	PINO
Greek_MD	PINO
Greek_Mod	PINO
Greek_D	PINO
Greek_K	PINO
Wakhi	PEV
Wakhi	PU
Albanian_T	ME-PIRE
Albanian_Top	PI
Albanian_Top	PIVA
Albanian_G	PI
Albanian_K	PII
ALbanian_C	PI
