Kashmiri	ZUWUN
Marathi	JEGNE
Gujarati	JIWEWU
Lahnda	JIWEN
Hindi	JINA
Bengali	JIOA
Nepali_List	JIUNU
Khaskura	JIUNO
Greek_ML	DZO
Greek_MD	DZO
Greek_Mod	ZO
Greek_D	DZO
Greek_K	DZO
Afghan	ZVAND-KAVEL
Persian_List	ZENDEGI-KARDAN
Tadzik	ZINDAGI-KARDAN
Baluchi	ZINDAGH
Albanian_G	JETOJ
Latvian	DZIVOT
Slovenian	ZIVI
Lusatian_L	ZYWIS-SE
Lusatian_U	ZIC
Czech	ZITI
Slovak	ZIT
Czech_E	ZIT
Ukrainian	ZYTY
Byelorussian	ZYC*
Polish	ZYC
Russian	ZIT
Macedonian	ZIVEE
Serbocroatian	ZIVITI
Singhalese	JIVAT
