Greek_ML	STEKOMAI
Greek_MD	STEKOMAI
Greek_Mod	STEKOME
Greek_D	STEKOMAI
Romanian_List	STA
Vlach	STAU
German_ST	STEHEN
Penn_Dutch	SCHTAY
Dutch_List	STAAN
Afrikaans	STAAN
Flemish	STAEN
Frisian	STEAN
Swedish_Up	STA
Swedish_VL	STA
Swedish_List	STA
Danish	STAA
Riksmal	STA
Icelandic_ST	STANDA
Faroese	STANDA
English	STAND
Lithuanian_O	STOVETI
Lithuanian_ST	STOVETI
Latvian	STAVET
Slovenian	STAJ
Lusatian_L	STOJAS
Lusatian_U	STEJEC
Czech	STATI
Slovak	STAT
Czech_E	STAT
Ukrainian	STOJATY
Byelorussian	STAMC*
Polish	STAC
Russian	STOJAT
Macedonian	STANE
Macedonian	STOI
Bulgarian	DA-STOI
Serbocroatian	STAJATI
Persian_List	ISTADAN
Tadzik	ISTODAN
