Provencal	CHUCHA
Spanish	CHUPAR
Portuguese_ST	CHUPAR
Portuguese_ST	CHUCHAR
Brazilian	CHUPAR
Brazilian	CHUCHAR
Macedonian	CICA
Slovenian	SOSAT
Czech	SSATI
Slovak	SAT
Ukrainian	SSATY
Byelorussian	SSAC*
Polish	SSAC
Russian	SOSAT
Serbocroatian	SISATI
Irish_B	SUGHAIM
Welsh_N	SUGNO
Welsh_C	SUGNO
Breton_List	SUN
Breton_SE	SUNEIN
Breton_ST	SUNAN
Romanian_List	SUGE
Vlach	SUKU
Italian	SUCCHIARE
Provencal	SUCA
French	SUCER
Walloon	SUCI
French_Creole_C	SUSE
French_Creole_D	SUSE
Sardinian_N	SUTHTHARE
Sardinian_L	SUZZARE
Sardinian_C	SUCCAI
Brazilian	SUGAR
German_ST	SAUGEN
Dutch_List	ZUIGEN
Afrikaans	SUIG
Afrikaans	SUIE
Flemish	ZUIGEN
Frisian	SUGE
Frisian	SUGJE
Swedish_Up	SUGA
Swedish_VL	SUG
Swedish_List	SUGA-PA
Danish	SUGE
Riksmal	SU
Icelandic_ST	SJUGA
Faroese	SUGVA
English	SUCK
Sranan	ZUIGI
Latvian	ZIST
Latvian	SUKT
