German_ST	BINDEN
Penn_Dutch	BINN
Dutch_List	BINDEN
Afrikaans	BIND
Flemish	BINDEN
Swedish_Up	BINDA
Swedish_VL	BIN
Swedish_List	BINDA
Danish	BINDE
Riksmal	BINDE
Icelandic_ST	BINDA
Faroese	BINDA
Romani	PHANDAV
Singhalese	BANDINAWA
Marathi	BANDHNE.
Gujarati	BAHDHWU
Panjabi_ST	BENNENA
Lahnda	BENNEN
Hindi	BADHNA
Bengali	BADHA
Nepali_List	BADHNU
Ossetic	BAETTYN
Persian_List	BASTAN
Tadzik	BASTAN
Tadzik	BOFTAN
Baluchi	BANDAGH
Baluchi	BASTHA
