German_ST	WARM
Penn_Dutch	WAAREM
Dutch_List	WARM
Afrikaans	WARM
Flemish	WARM
Frisian	WAERM
Swedish_Up	VARM
Swedish_VL	VARM
Swedish_List	VARM
Danish	VARM
Riksmal	VARM
English	WARM
Sranan	WARAM
Marathi	GEREM
Gujarati	GEREM
Panjabi_ST	GEREM
Lahnda	GERMI
Hindi	GEREM
Bengali	GOROM
Greek_K	THERMOS
Ossetic	X*ARM
Persian_List	GARM
Tadzik	GARM
Baluchi	GARM
Wakhi	GERM
