Irish_A	SINN
Irish_B	INN
Irish_B	SINN
Irish_B	SINNE
Irish_B	INNE
Macedonian	NIE
Welsh_N	NI
Welsh_C	NI
Breton_List	NI
Breton_SE	NI
Breton_ST	NI
Bulgarian	NIE
Albanian_T	NE
Albanian_Top	NEVE
Albanian_Top	NE
Albanian_G	NE
Albanian_K	NA
ALbanian_C	NA
Romanian_List	NOI
Vlach	NOI
Italian	NOI
Ladin	NUS
Provencal	NOUS
Provencal	NAUTRE
French	NOUS
Walloon	NOS
French_Creole_C	NU
French_Creole_D	NU
Sardinian_N	NOIS
Sardinian_L	NOS
Sardinian_C	NOSUS
Spanish	NOSOTROS
Portuguese_ST	NOS
Brazilian	NOS
Catalan	NOSALTRES
Albanian_K	I-NOTISURE
