Provencal	QUE
French	QUE
Walloon	QUI
Walloon	QWE
Spanish	QUE
Portuguese_ST	QUE
Brazilian	QUE
Catalan	QUIN
Catalan	QUE
Lithuanian_O	KA
Lithuanian_ST	KAS
Latvian	KAS
Slovenian	KAY
Kashmiri	KYAH
Marathi	KAY
Panjabi_ST	KI
Lahnda	KE
Hindi	KYA
Bengali	KI
Nepali_List	KE
Nepali_List	KO
Khaskura	KYA
Lusatian_L	CO
Lusatian_U	STO
Czech	CO
Slovak	CO
Czech_E	CO
Ukrainian	SCO
Byelorussian	STO
Polish	CO
Russian	CTO
Macedonian	STO
Serbocroatian	STO
Romanian_List	CE
Vlach	CI
Italian	CHE
Ladin	CHE
French_Creole_C	KI-SA
French_Creole_D	D
Sardinian_L	CHI
Afghan	CE
Waziri	KIM
Waziri	TSE
Persian_List	CHE
Tadzik	CI
Wakhi	CIZ
Wakhi	CICIZ
Albanian_Top	CE
Albanian_G	TSH
Albanian_K	CE
ALbanian_C	CE
