Irish_A	CIA
Irish_B	CIA
Irish_B	CIACA
Albanian_Top	CILI
Romanian_List	CINE
Italian	CHI
Ladin	CHI
Sardinian_L	CHINI
Ossetic	CI
Provencal	QUE
Provencal	QUAU
Provencal	QU*
French	QUI
Walloon	KI
Walloon	QUI
French_Creole_C	KI-MUN
French_Creole_D	KIMUN
Sardinian_N	KIE
Sardinian_C	KINI
Spanish	QUIEN
Portuguese_ST	QUEM
Brazilian	QUEM
Catalan	QUI
Bengali	KE
Persian_List	KI
Tadzik	KI
Baluchi	KITHAN
Wakhi	KUI
