Lithuanian_O	VEJAS
Lithuanian_ST	VEJAS
Latvian	VEJS
Lusatian_L	WETS
Lusatian_U	WETR
Czech	VITR
Slovak	VIETOR
Czech_E	VETR
Ukrainian	VITER
Byelorussian	VECER
Polish	WIATR
Russian	VETER
Macedonian	VETER
Bulgarian	VJATER
Serbocroatian	VETAR
Welsh_N	GWYNT
Welsh_N	CHWA
Welsh_C	GWYNT
Breton_List	GWENT
Romanian_List	VINT
Vlach	VINTU
Italian	VENTO
Ladin	VENT
Provencal	VENT
French	VENT
Walloon	VINT
French_Creole_C	VA
French_Creole_D	VA
Sardinian_N	VENTU
Sardinian_L	BENTU
Sardinian_C	BENTU
Spanish	VIENTO
Portuguese_ST	VENTO
Brazilian	VENTO
Catalan	VENT
German_ST	WIND
Penn_Dutch	WINDT
Dutch_List	WIND
Afrikaans	WIND
Flemish	WIND
Frisian	WYN
Swedish_Up	VIND
Swedish_List	VIND
Danish	VIND
Riksmal	VIND
Icelandic_ST	VINDR
Faroese	VINDUR
English	WIND
Sranan	WINTI
