Welsh_N	CHWI
Welsh_C	CHWI
Breton_List	C*HOUI
Breton_SE	HUI
Breton_ST	C*HWI
Lusatian_L	WY
Lusatian_U	WY
Czech	VY
Slovak	VY
Czech_E	VI
Byelorussian	VY
Polish	WY
Russian	VY
Macedonian	VE
Macedonian	VIE
Bulgarian	VIE
Serbocroatian	VI
Romanian_List	VOI
Vlach	VOI
Italian	VOI
Ladin	VUS
Provencal	VOUS
Provencal	VAUTRE
French	VOUS
Walloon	VOS
Sardinian_N	VOIS
Sardinian_L	VOS
Sardinian_C	BOSATRUS
Spanish	VOSOTROS
Portuguese_ST	VOS
Brazilian	VOS
Catalan	VOSALTRES
