Afrikaans	JULLE
Afrikaans	JUL
Flemish	U
Flemish	GY
Frisian	JY
Frisian	JO
Frisian	JIM
Swedish_VL	JI
Swedish_List	I
Danish	I
English	YE
Lithuanian_O	JUS
Lithuanian_ST	JUS
Latvian	JUS
Slovenian	JE
Albanian_T	JU
Albanian_Top	JURE
Albanian_G	JU
Albanian_K	JU
ALbanian_C	JU
