Romanian_List	AN
Vlach	ANU
Italian	ANNO
Ladin	AN
Ladin	ANNEDA
Provencal	AN
Provencal	ANNADO
French	AN
Walloon	AN
Walloon	ANNEYE
French_Creole_C	LANE
French_Creole_C	A
French_Creole_D	LANE
Sardinian_N	ANNU
Sardinian_L	ANNU
Sardinian_C	ANNU
Spanish	ANO
Portuguese_ST	ANNO
Brazilian	ANO
Catalan	ANY
